11 11
 **********
     ******
** *      *
** * **** * 
** ****** * 
*     *** * 
*** * *** *
**  * *** * 
*  ** *** *
* *** *   *   
*****/*****
