11 11
 *   ******
   *     **
 * * *** **
 * *  ** **
*  *   *  *
******  * *
 * *   *  *
     * ****
* ** *   **
* *  * *  /
*/*********
